אליפות אפריקה
אליפות אפריקה תיפתח ב-10 בינואר ושוב תפגע קשות בקבוצות בשלב קריטי של העונה .  רשימת העוזבים
אליפות אפריקה שתיפתח ב-10 בינואר באנגולה יוצרת ,  אחת לשנתיים ,  כאב ראש לא פשוט למאמני הקבוצות ביבשת .  השחקנים יוצאים לתקופה של כשלושה שבועות ומשאירים את הקבוצות בסגל מצומצמם באחד השלבים בקריטיים של העונה .  
אברהם גרנט ,  שביקר לאחרונה את פיפ"א על קיום האליפות בחודש ינואר ,  יצטרך להסתדר לא שלושה שחקני הרכב :  נאדיר בלחאג' וחסן יבדה האלג'יראים וכן ארונה דינדאן מחוף השנהב .  לצורך ההשוואה ,  ניס הצרפתית תחסר לא פחות משישה שחקני סגל שיחסרו לה במאבקי התחתית .  
 להלן רשימת החוסרים של קבוצות הצמרת באירופה .  
אנגליה :  
צ'לסי :  דידייה דרוגבה ,  סלומון קאלו ,  מייקל אסיין ,  ג'ון אובי מיקל 
מנצ'סטר יונייטד - אין 
מנצ'סטר סיטי :  קולו טורה ,  עמנואל אדבאיור 
ארסנל :  עמנואל אבואה ,  אלכסנדר סונג 
ספרד :  
ברצלונה :  יאיא טורה ,  סיידו קייטה
ריאל מדריד :  ממאדו דיארה 
סביליה :  דידייה זוקורה ,  פרדי קאנוטה 
איטליה :  
אינטר :  סולי מונטארי ,  סמואל אטו 
מילאן :  דומיניק אדייה 
יובנטוס :  מוחמד סיסוקו 
גרמניה :  
המבורג :  גי דמל ,  ג'ונתן פיטרויפה 
לברקוזן :  האנס סארפיי ,  אסימיו טורה
שאלקה :  ז'ואל מאטיפ 
דורטמונד :  מוחמד זידאן 
צרפת :  
מארסיי :  אנדרה אייוו ,  צ'רלס קאבורה ,  בקארי קונה ,  טאייה טאיוו ,  סטפן מ'ביה 
ליל :  פייר אמריק אובמיאנג ,  ז'רביניו ,  אורליין שדג'ו 
ליון :  ז'אן מאקון 
בורדו :  אבדו טראורה

אליפות אפריקה
אליפות אפריקה תיפתח ב-10 בינואר ושוב תפגע קשות בקבוצות בשלב קריטי של העונה .  רשימת העוזבים

